1111111111111111111111111111111111
1E0000000010000C10000C000000000001
1010010100100001101001000000010101
1010010010001010001001000000010101
1P0000000C10C0000000000000000000C1
1C00001110000000000000000000000001
1000000000000000000000000000000001
1000000000000000000000000000000001
10000000000C0000000000000000000001
1000000000000000000000000000000001
1111111111111111111111111111111111
