1111111111
1C000000C1
1000000011
1E000001P1
1111111111
