1111111111
1C000000C1
1000000001
1E00000iP1
1111111111
