1111111111
1C000000C1
1000000001
1E000000P1
1111111110
