11111111111
1P0000000C1
100C00000E1
111111111111
